############################
##     #####   #############
##        ##   ###    ######
##     ## ##   ###### ######
#### #### ### ####### #    #
#### ####          ##      #
#### ######## #### ####    #
##     ########### ####    #
##                 ###### ##
##     ################## ##
#### #########        ### ##
#### #########        ### ##
#### ##     ##        ### ##
##             ### ###### ##
#######     ###### ###### ##
#### #### ######     #### ##
#### #### ######          ##
#### ####     ##     #### ##
##    ### ### #### ###### ##
## ## ### ### #### ###### ##
## ## ##                  ##
## ############### #### ####
##      ##            # ####
## ##   ## ## #### #### ####
## ##   ## ## #### ##     ##
## ##      #   ###        ##
############   #############
############################