          #   #        #   #  #     # #          #
    #     # #      #   #    ##         ##  ##     
   #         ##  #                    # #         
   ###  #          #     #     # #         #   #  
##      #             #   #     #      #       ## 
                       #      #             #     
     #    ##         #      #                 #   
  #    #   #            #           #             
##        #         #                #    # #     
 ##   #    #     #    # #                   # #   
  ##  #                                     # #   
      #  # #         # # # ##                #   #
     #   #      ###  #             ##   #   #  #  
 #        #   #        #    #     #  #        #   
#          ##                     # #       #     
  #   #  #   #  # #   #    #               ##   # 
        #            #                        #  #
 ##    # #        ### #     ##   #              # 
    #  # #  #        #    #       ##     #   #    
                         ##         #       #  #  
          #   #     #                     #   #   
                      ##                 ##       
    #   #             # ##   #     ## #   #       
     #          #  #               #  #  #        
   #            #    #   # #                #     
          # #   #        # #  #         ##      # 
   ##     #  #              #          ##        #
#   # # ##            #  #            #           
   # #     #       # #        ##            #     
      #    # #      # #                    #  #   
     #  #    #               #        # ##        
 #            #   #    #  ## #  #  ##             
          #             ##  #     #      #   #    
 # #   ##   # #         #                 ##      
  #        # #  #     ##   #         # #        # 