############################
############################
############################
###                      ###
### ########### ######## ###
### ########### ######## ###
### ##   #   #   #   ### ###
### ##       #   #   ### ###
### ##   #   #   #   ### ###
### ####### ### ### #### ###
### ##   ## ### ### #  # ###
###                    # ###
### ##   ## ####### #  # ###
### ### ### ####### #### ###
### ##   #   #   #   ### ###
### ##   #       #   ### ###
### ##   #   #   #   ### ###
### ### ####### ######## ###
### ##   ####     ##   # ###
### ##   ####     ##   # ###
### ################# ## ###
###                      ###
###### ####### ###### ######
###### ####### ###### ######
####     ###     ##     ####
####     ###     ##     ####
####     ###     ##     ####
############################