############################
#   #################   ####
#   ########   ######   ####
## ####        ######   ####
## #### ####   ####### #####
##      ############## #####
## ################### #####
## ################       ##
## ########     ###       ##
##      ###     ###       ##
### ### ###     ###       ##
### ### ##### ######## #####
##   ## ##### ######## #####
##   ## ##### ######     ###
##   ## ##### ###### ### ###
#######              ### ###
####### ############ ### ###
####### ############ ### ###
##   ## ##   #####    ## ###
##           #####    ## ###
##   ## ##   #####    ## ###
####### ################ ###
####### ######           ###
######    #### #############
######    #### #############
######    ##     ###########
############     ###########
############################